S0100000100010001000
00100100101010101000
01100100101010101010
00000100101010101010
00000100101010101010
11111100101010101010
00000000101010101010
00000000101010101000
01111111101010101000
00000000001010101010
00000000001010101010
11111111111010101010
00000000000010101010
01111111111110101010
00000000000000101010
11111111111111101010
00000000000000001010
01111111111111111010
00010001000100010010
0100010001000100011E