00000000000000000000
00000000011000000000
00000000011000000000
00000000011000000000
00000000011000000000
00000000011000000000
00000000011000000000
00000S00011000E00000
00000000011000000000
00000000011000000000
00000000011000000000
00000000011000000000
00000000011000000000
00000000011000000000
00000000011000000000
00000000011000000000
00000000011000000000
00000000011000000000
00000000011000000000
00000000011000000000